NO textures/gryffindor.png
SO textures/slytherin.png
WE textures/ravenclaw.png
EA textures/hufflepuff.png

C 225,30,50
F 220,5,77


             11111111111111111111111111111111111
             100000000000000000000S0000000000001
             11111100000000000000000000000000001
                   10000000000000000000000000001
                   10000000000000000000000000001
                   10000011111111111111111111111
                   1000001
                   1000001
 11111111111111    1000001
1000000000000001   1000001
1000000000000001   1000001
1000011111100001111100000111111
100001    100000000000000000001
100001    100000000000000000001
1000011111100001111111111111111
1000000000000001
 111110000011111
    100000001
    100000001
    111111111
1111
1001
1111