NO textures/arte-egipcio.jpg
SO textures/mandala-kalachakra.jpg
WE textures/pergamon.jpg
EA textures/parc-guell-gaudi.jpg

C 145,23,33
F 0,255,55

 111    111111111111111111111111111111
 101    100000000011000000000000111111
 111    1011000001110000000000001111111111
        1001000000000000000000000000000001
11111111101100000111000000000000100W000001 
100000000011000001110111111111111000000001
11110111110111011100000010001    10011111
11110111011111011101010010001    1001                                                           1
11000011110101011100000010001    1001                                                          101
1000001   10000001100000010001   1001                                                           1
1000001   10000001101010010001   1001
110000011101010111110111100111    11
11110111 1110101 101111010001
11111111 1111111 111111111111