NO textures/arte-egipcio.jpg
SO textures/mandala-kalachakra.jpg
WE textures/pergamon.jpg
EA textures/parc-guell-gaudi.jpg

C 225,30,0
F 220,5,77

        1111111111111111111111111
        1000000000110000000000001
        1011000001110000000000001
        1001000000000000000000001
111111111011000001110000000000001
100000000011000001110111111111111
11110111110111011100000010001
11110111011111011101010010001
11000000110101011100000010001
10000000000000001100000010001
10000000000000001101010010001
110000011101010111110111100111
1111E111 1110101 101111010001
11111111 1111111 111111111111
